NO ./textures/eagle.xpm
SO ./textures/greystone.xpm
WE ./textures/purplestone.xpm
EA ./textures/red.xpm
F 225,100,0
C 225,30,0

1111111111111111
1000000101001011
1000010000000101
1001000000N00101
1000000100000011
1000000000000001
1111111111111111