NO ./textures/eagle.xpm
SO ./textures/greystone.xpm
WE ./textures/purplestone.xpm
EA ./textures/red.xpm
F 225,100,0
C 225,30,0

  11111111111111  
110000000000001 
  10000N00000111
 1000000100000001  
  10000100000011
 100000000000011
11111111111111