NO ./textures/eagle.xpm
SO ./textures/greystone.xpm
WE ./textures/purplestone.xpm
EA ./textures/red.xpm
F 225,100,0
C 225,30,0
1111111111111111111111111111
  1000000000110000000000001
   1011000001110000000001111
1111100000000000000000001
11111111101100S0011100001111
100000000011000001110111111111111        
11110111111000000111011100000010011
1111011111111101110101001000111111
11000000110101011100000010001
111111000000000000000110000001111
10000000000000001101010010001
110000011101010111110111100111
1111011111101011101111010001
1111111111111111111111111111